1111111111111
100100C0P0011
1E00011111001
1111111111101
1000000000001
1111111111111
