1111111111111
10010P0E00C11
1000011111001
1111111111111
