1111111111111
1C0100E0C0011
1000011111001
1111111111101
1C000000P0001
1111111111111
