1111111111111
1C0100E000C11
1000011111001
1111111111101
1C0000P000001
1111111111111
