1111111111111
100100E000C11
1000011111001
1111111111101
100000P000001
1111111111111
