1111111111111
10010000A0011
1000011111001
1111111111101
1000000000000
1111111111111
