1111111111111
1C010000C0011
1000011111001
1111111111101
1C000E00P0001
1111111111111
