1111111111111
10010000E0C11
1000011111001
1110111111111
100000P000001
1111111111111
