1111111111111
1C01000P01011
10E0011111001
1111111111101
1000000000001
1111111111111
